NO ./texture/wall_1.xpm


     SO ./texture/wall_2.xpm
WE ./texture/wall_3.xpm
         EA            ./texture/wall_4.xpm
            F 220, 100, 0
C 1, 225, 30

111111111111111111111111
100000000110000000000001
1011000001110000000000001
1001000000000000000000001
11111111011000001110000001
100000000011000001110111111111111
1111011111111101110000001111
11110111111110111010100100011111
111111100110101011100N00110001
      1111100000000000000011001111
      1000000000000001101010010001
     110100011101010111110111111111
11111111 1110101 101111010001
1111111 1111111 111111111111