
NO ./texture/wall_1.xpm


	SO ./texture/wall_2.xpm 
      
WE ./texture/wall_3.xpm
         EA            ./texture/wall_4.xpm
            F 125, 25, 25          
C 0, 0, 255

11111111111111111111111111
100000000110000001100000011
101100000111000000110000111
	1001000000000000000000001
11111111011000001110000001
100000000011000001110111111111111
1111011111111101110000001111
11110111111110111010100100011111
111111100110101011100000110001
      1111100000000000000011001111
      100000000N000001101010010001
     110100011101010111110111111111
11111111 1110101 101111010001
1111111 1111111 111111111111