NO ./texture/wall_1.xpm
SO ./texture/wall_2.xpm
WE ./texture/wall_3.xpm
EA ./texture/wall_4.xpm
F 220,100,0
C 225,30,0
		1111111111111111111111111
		1000000000110000000000001
		1011000001110000000000001
		1001000000000000000000001
111111111011000001110000011111111
100000000011000001110111111111111
11110111111111011100000010001
11110111111111011101010010001
11000000110101011100W00010001
10000000000000001100000010001
1000000000000001101010010001
11000001110101011111011110001
11110111 1110101 101111110001
11111111 1111111 11111  1111111
